abis	sangat
abiss	sangat
access	akses
ad	ada
adain	adakan
adakah	adakah
adlh	adalah
aj	aja
ajg	anjing
akn	akan
aktifasi	aktivasi
aktifin	aktifkan
aktifitas	aktivitas
aktip	aktif
aktipkan	aktifkan
akudan	aku dan
alamin	alami
alhamdulilah	alhamdulillah
all	semua
allsudah	semua
amat	sangat
amburadul	buruk
amin	aamiinn
ampe	sampai
anj	anjing
anjir	anjing
antarmuka	antar muka
aowkwkw	tertawa
apaan	apa
apain	apa
apalg	apalagi
apanya	apa
apilikasi	aplikasi
apk	aplikasi
apknya	aplikasi
apl	aplikasi
apliaksinya	aplikasi
aplikasi	aplikasi
aplikasih	aplikasi
aplikasiny	aplikasi
aplikasinya	aplikasi
aplikasinyamemudahkan	aplikasi memudahkan
apliksanya	aplikasi
apliksi	aplikasi
app	aplikasi
appl	aplikasi
application	aplikasi
applikasi	aplikasi
applikasinya	aplikasi
appnya	aplikasi
approved	setuju
apps	aplikasi
are	adalah
asu	anjing
atasinya	atasi
atik	proses
ato	atau
ausah	susah
bagusin	bagus
bagusnya	bagus
bagusnyamanaman	bagus nyaman aman
baguss	bagus
bangetbisa	banget bisa
bangetjoss	banget jos
bangetkomplen	banget komplain
bangetlah	banget
bangetmudah	banget mudah
bangett	banget
bangettg	banget
bangettp	banget
bangtt	banget
bantuannya	bantuan
banya	banyak
banyakin	banyak
banyakk	banyak
baringpun	berbaring
bayaar	bayar
bayarnya	bayar
bayay	bayar
beguna	berguna
benefits	keuntungan
bener	benar
beratt	berat
berkualitasjadi	berkualitas jadi
besoknya	besok
best	terbaik
betmanfaat	bermanfaat
bgs	bagus
bgt	banget
bgtt	banget
bgus	bagus
biasahanya	biasanya
bisawifi	bisa wifi
blm	belum
bln	bulan
blom	belum
bnget	banget
bngetmohon	banget mohon
bngt	banget 
bnr	benar
bnyak	banyak
bnyk	banyak
bosen	bosan
brp	berapa
bs	bisa
bsa	bisa
bufering	penyangga
bwrmasalah	bermasalah
call	panggil
care	peduli
catching	menarik
center	pusat
cepet	cepat
check	cek
clean	bersih
closed	tutup
cm	cuma
cma	cuma
complain	komplain
coneksi	koneksi
content	kontent
control	kontrol 
copy	salin
corona	korona
cs	cs
cuman	cuma
customer	pelanggan
daan	dan
dah	sudah
dahh	sudah
dakses	diakses
dapet	dapat
datanf	datang
dateng	datang
dech	deh
decline	menolak
degan	dengan
dehh	deh
denger	dengar
desai	desain
design	desain
developer	pengembang
developernya	pengembangnya
device	perangkat
dg	dengan
dgn	dengan
diapa	di apa
diaplikasi	di aplikasi
dicoabin	dicoba
didalam	di dalam
didalamnya	di dalamnya
difahami	dipahami
difollowup	ditindaklanjuti
digunain	digunakan
dihati	di hati
dihubungitelkom	dihubungi telkom
diingetin	diingatkan
dijalan	di jalan
dikembangin	dikembangkan
dikit	sedikit
dikumpulin	dikumpulkan
dimintol	diminta tolong
dipahamigood	dipahami good
dipahamii	dipahami
dipahamiperbaiki	dipahami perbaiki
dipahamisangat	dipahami sangat
dipake	dipakai
diperbaharui	diperbarui
diperbincangkanerror	diperbincangkan error
direspongada	direspon ada
dirumah	di rumah
disaat	di saat
disetiap	di setiap
ditelp	ditelpon
ditempat	di tempat
ditukarkansangat	ditukarkan sangat
dkit	sedikit
dll	dan lain lain
dn	dan
doang	saja
doanggw	saja
dolo	dulu
donk	dong
donlod	unduh
down	turun
downgrade	turun kelas
downgread	turun kelas
download	unduh
dpt	dapat
dr	dari
drakoran	drakor
dri	dari
ekseskusi	eksekusi
emang	memang
engga	tidak
enggak	tidak
entar	nanti
eror	error
erornya	error
errorlah	error
excellent	bagus sekali
excitement	kegembiraan
experience	pengalaman
eye	mata
far	jauh
fast	cepat
fastrespon	respon cepat
fitu	fitur
fiture	fitur
fiturna	fiturnya
follow	mengikuti
force	memaksa
free	bebas
friendly	ramah
full	penuh
fun	lucu
g	tidak
ga	tidak
gabisa	tidak bisa
gajelas	tidak jelas
gak	tidak
gamas	gemas
gaming	game
gangguantarifnya	gangguan tarifnya
ganguan	gangguan
garcepdatang	gerak cepat datang
gatau	tidak tahu
gede	bisa
gercep	gerak cepat
gimana	bagaimana
gini	begini
gitu	begitu
gk	tidak
gmn	bagaimana
gmna	bagaimana
god	tuhan
good	bagus
goodjob	kerja bagus
gopd	bagus
gpp	tidak apa apa
gtu	begitu
gua	saya
gue	saya
gunain	gunakan
gunakanprogram	gunakan program
gunakansma	gunakan
guys	teman-teman
guyss	teman-teman
harisaat	hari saat
hbs	habis
hehe	tertawa
helpful	bermanfaat
hmpir	hampir
home	indihome
hrga	harga
hrus	harus
huhu	menangis
ialah	adalah
ilang	hilang
ilangan	hilang
indi	indihome
indie	indihome
indiehome	indihome
indigubuk	indihome
indihom	indihome
indihome	indihome
indihomebravo	indihome bravo
indihomebuat	indihome buat
indihomebukan	indihome buat
indihomee	indihome
indihomerespon	indihome respon
indihomesangat	indihome sangat
indihomesudah	indihome sudah
indihomme	indihome
indihomo	indihome
indohome	indihome
infonyapenjelasan	infonya penjelasan
inginkanpokok	inginkan pokok
inifitur	ini fitur
inikita	ini kita
inisaya	ini saya
inisemua	ini semua
internetbanyak	internet banyak
intinyaindihome	intinya indihome
is	adalah
isthebestop	terbaik top
it	itu
iy	iya
jaringanbikin	jaringan bikin
jaringanny	jaringannya
jaringanya	jaringannya
jd	jadi 
jdi	jadi 
jelass	jelas
jg	juga
jga	juga
jgn	jangan
jjika	jika 
job	pekerjaan
join	gabung
joss	jos
jugaa	juga
kaga	tidak
kalianaplikasi	kalian aplikasi
kalo	kalau
kampungkumemberikan	kampungku memberikan
kantongbanyak	kantong banyak
karna	karena
kayak	seperti
kedepanya	kedepannya
keep	jaga
kek	seperti
keluarperbaikan	keluar perbaikan
kemaren	kemarin
kenalpadahal	kenal padahal
kenapakrna	kenapa karena
kenceng	kencang
kendalan	kendala
kepengin	mau
kerenn	keren
keruskaan	kerusakan
kesel	kesal
keseluruan	keseluruhan
kitasy	kita
kk	kak
kl	kalau
klau	kalau
klo	kalau
klw	kalau
ko	kok
kompinan	komplain
komplen	komplain
konekne	tersambung
konsume	konsum
kontril	kontrol
koontol	kontol
krn	karena
krna	karena
ksni	kesini
kuattidak	kuat tidak
kuotacek	kuota cek
kwalitas	kualitas
kwalitasnya	kualitasnya
kyk	seperti
lagii	lagi
lagipas	lagi pas
lagisdh	lagi sedih
lainsemoga	lain semoga
lainya	lainnya
lamgsung	langsung
lancargood	lancar bagus
lancarr	lancar
lanjar	lancar
layananannya	layanannya
layananny	layanannya
lbih	lebih
lelet	lambat
leletbikin	lambat bikin
leluar	keluar
lemootapalagi	lambat apalagi
lemot	lambat
lemotkerjaan	lambat kerjaan
lengkaap	lengkap
lengkapp	lengkap
lg	lagi
lgi	lagi
lgidisaat	lagi di saat
lgsg	langsung
lhlagi	lagi
liat	lihat
lola	lambat
love	cinta
lpasword	password
luama	lama
luarbiasa	luar biasa
maap	maaf
macem	macam
maen	main
maintenance	pemeliharaan
makai	memakai
makainya	memakainya
makasi	terima kasih
makasih	terima kasih
make	memakai
makenya	memakainya
makin	semakin
malem	malam
manage	mengelola
mantaap	mantap
mantab	mantap
mantabjossdan	mantap jos dan
mantaf	mantap
mantapp	mantap
mantau	memantau
manteb	mantap
mantep	mantap
mantepp	mantap
mantul	mantap betul
markotop	mantap
masalahterimakasih	masalah terima kasih
masang	memasang
masi	masih
masukin	masukkan
matibiar	mati supaya
matignt	mati ganti
may	my
Aim Ibrahim,May Indihome mantapppp,5,2023-05-30 13:10:51	myindihome
me	saya
meembantu	membantu
melapurkan	melaporkan
membantumakasih	membantu terima kasih
membantuu	membantu
membarikan	memberikan
membatu	membantu
memntau	memantau 
menarikk	menarik
mengaksesnyafitur	mengaksesnya fitur
menggangu	mengganggu
menghubungin	menghubungi
menitsinyal	menit sinyal
menurutkujaringan	menurutku jaringan
mhn	mohon
midah	mudah
mindah	memindahkan
mintain	memintakan
mksih	terima kasih
mnculnya	munculnya
mnggu	minggu
mntap	mantap
mo	mau
moga	semoga
mqu	mau
msh	masih
mslh	masalah
muak	bosan
mudahdalam	mudah dalam
mudahin	mudahkan
mudahterimaksih	mudah terima kasih
mudahterpecaya	mudah terpercaya
mulu	selalu
murahtolong	murah tolong
muter	putar
myindhome	myindihome
myindihe	myindihome
myindihomr	myindihome
myindohome	myindihome
mylindhome	myindihome
mylndihome	myindihome
napa	kenapa
nawarin	menarwarkan
nelpon	menelpon
nemu	menemukan
new	baru
nga	tidak
ngabisin	menghabiskan
ngaduin	mengadukan
ngajuin	mengajukan
ngaruh	berpengaruh
ngasih	memberikan
ngebantu	membantu
ngecek	mengecek
ngelagwajib	ngelag wajib
ngeleg	ngelag
ngerti	mengerti
ngga	tidak
nggak	tidak
nggk	tidak
ngikut	mengikuti
ngk	tidak
nglag	ngelag
ngontrol	mengontrol
ngutamain	mengutamakan
ngutang	hutang
ni	nih
nice	bagus
nich	nih
nihh	nih
nii	nih
nma	nama
nntn	nonton
no	nomor
nomer	nomor
non	tidak
ntah	entah
nua	nya
nukarin	menukarkan
nunggu	menunggu
ny	nya
nyaa	nya
nyampe	sampai
nyesel	menyesal
nyoba	mencoba
nyobain	mencoba
ok	mantap
oke	mantap
okelah	mantap
okk	mantap
orgmna	orang mana
orgtpi	orang tapi
out	keluar
over	melebihi
overall	keseluruhan
pahamidan	pahami dan
pakaidati	pakai hati
pake	pakai
pakek	pakai
paken	pakai
paketjika	paket jika
paketny	paketnya
parahh	parah
pasanggw	pasang
passwort	password
past	pasti
paste	salin
pasword	password
payment	pembayaran
pdhal	padahal
pekerjaankomunikasi	pekerjaan komunikasi
pel	pelanggan
pelangan	pelanggan
pelanggann	pelanggan
pelangganpelayanan	pelanggan pelayanan
pelayananan	pelayanan
pelayananny	pelayanannya
pelayanannyajarang	pelayanannya jarang
pelayananya	pelayanannya
pemakain	pemakai
pembayarankrn	pembayaran karena
pembayaranya	pembayarannya
pembelin	pembeli
pemulaa	pemula
penanganannyagada	penanganannya yang ada
penangananya	penangannanya
pengen	ingin
penyelesainnya	penyelesainnya
perbaikin	perbaiki
perbaikisama	perbaiki sama
perbulan	tiap bulan
perbulannya	tiap bulannya
perfect	sempurna
performa	kinerja
performanya	kinerjanya
perna	pernah
pertahanin	pertahankan
pertahun	tiap tahun
perugas	petugas
pikirinjadi	pikir jadi
pindahingat	pindah ingat
pke	mantap
pkoknya	pokoknya
plus	tambah
pnya	punya
point	poin
poinya	poinnya
pokoke	pokoknya
pokoknga	pokoknya
pokokny	pokoknya
pokoknya	pokoknya
pokoknyaa	pokoknya
pokonamh	pokoknya
pokonya	pokoknya
pokonyabisa	pokoknya bisa
pol	sangat
prabyarnya	prabayar
problem	masalah
professional	profesional
promoo	promo
prosespunya	proses punya
providerny	providernya
psg	pasang
puass	puas
publish	menerbitkan
pul	penuh
purchase	pembelian
purchasing	percikan
putur	putus
qt	kita
ramaah	ramah
ramahmemuaskan	ramah memuaskan
rb	ribu
real	nyata
reccomend	direkomendasikan
recomend	direkomendasikan
recomended	direkomendasikan
recomendedkarena	direkomendasikan karena
recomendet	direkomendasikan
recommend	direkomendasikan
recommended	direkomendasikan
refresh	segarkan
refresment	refreshment
register	pendaftar
registrasi	pendaftaran
rekomend	rekomendasi
rekomendasisangat	rekomendasikan sangat
rekomended	rekomendasi
rekommended	direkomendasikan
renew	memperbarui
repeater	pengulang
report	laporan
request	permintaan
responcepat	respon cepat
respond	respon
restar	restart
review	tinjauan
reward	hadiah
rewards	hadiah
ribett	ribet
riview	tinjauan
rmh	rumah
rumahapalagi	rumah apalagi
sampe	sampai
sampein	sampaikan
samsek	sama sekali
sangaat	sangat
sangan	sangat
sangatt	sangat
sangw	sangat
saranin	sarankan
sasuai	sesuai
satsetsatset	cepat
say	saya
sayaa	saya
sbg	sebagai
sblum	sebelum
scr	secara
sdh	sudah
sebelahmurah	sebelah murah
sekalisemua	sekali semua
seklai	sekali
self	diri
sendir	sendiri
seneng	senang
seprti	seperti
serimg	sering
serubeharap	seru berharap
service	pelayanan
servis	pelayanan
sesui	sesuai
seterunya	seterusnya
sgt	sangat
shopeemakasih	shopee terima kasih
signal	sinyal
sihkrn	sih karena
sikit	sakit
simple	simpel
sinyall	sinyal
sinyl	sinyal
sipmantapkalo	sip mantap kalau
sipp	sip
skali	sekali
skr	sekarang
skrang	sekarang
skrg	sekarang
skrng	sekarang
slalu	selalu
slma	selama
slow	lambat
sm	sama
smakin	semakin
smart	cerdas
smartphone	
smoa	semoga
smoga	semoga
smooa	semoga
smooth	mulus
smpe	sampai
smua	semua
sngat	sangat
so	jadi
sorry	maaf
speed	kecepatan
speeds	kecepatan
speedtest	kecepatan tes
sprti	seperti
spt	seperti
stabilacara	stabil acara
start	mulai
suiib	suib
sukaa	suka
sukak	suka
sunggu	sungguh
support	dukung
swmoga	semoga
sy	saya
sya	saya
tagiahan	tagihan
tahunsangat	tahun sangat
tak	tidak
tambh	tambah
tamplian	tampilan
tanks	terima kasih
tdk	tidak
team	tim
telfon	telepon
telp	telepon
telpon	telepon
temen	teman
tenan	benar
terbaikterimakasih	terbaik terima kasih
terhubungdll	terhubung dan lain-lain
terhubunglayanan	terhubung layanan
terimakaaih	terima kasih
terimakasih	terima kasih
terimaksih	terima kasih
terimasih	terima kasih
terkoneksid	terkoneksi
teros	terus
terusmekanik	terus mekanik
teruss	terus
tetep	tetap
tgl	tanggal
th	tahun
thanks	terima kasih
thn	tahun
thxx	terima kasih
time	waktu
tivi	tv
tlg	tolong
tlolootollotloll	tolol
tlp	telepon
tmbah	tambah
to	ke
tololl	tolol
tools	peralatan
toolsnya	peralatannya
topbgt	top banget
tp	tapi
tpi	tapi
tracking	pelacakan
tranparan	transparan
trf	transfer
trim	terima kasih
trima	terima
trimakasih	terima kasih
trims	terima kasih
trimss	terima kasih
trobel	masalah
trouble	masalah
trross	terus
trs	terus
trus	terus
ttp	tetap
tu	itu
tuker	tukar
tydak	tidak
udah	sudah
udh	sudah
unlimited	tidak terbatas
untik	untuk
up	atas
update	terbaru
upgrade	terbaru
upgread	terbaru
useless	tidak berguna
user	pengguna
utak	proses
utk	untuk
variatif	variatif
variatifsaya	variatif saya
verifikasi	verifikasi
verry	sangat
voucer	voucher
wahh	wah
waktunyabener	waktunya benar
wallet	dompet
was	waspada
weslah	sudah
wiffi	wifi
wifii	wifi
wifinnya	wifinya
wkt	waktu
wkwk	tertawa
work	kerja
wort	sepadan
worth	sepadan
ya	iya
yaa	iya
yaoke	iya mantap
yg	yang
you	kamu
yt	youtube
yu	yuk
ajaaa	aja
anjirrr	anjir
asuuuuuuu	anjing
bagusss	bagus
bagussss	bagus
bangettt	banget
bangetttt	banget
bangettttt	banget
bangetttttt	banget
bener	benar
bermanfaattt	bermanfaat
bgttt	banget
cepattt	cepat
dahhh	dah
dannn	dan
dehhh	deh
fitunya	fitur
fiturnya	fitur
fiturnyaaa	fitur
gada	tidak ada
gnt	ganti
gtu	gitu
guysss	teman-teman
gw	saya
indihomenya	indihome
iniiii	ini
internetnya	internet
isthebes	terbaik
iyaaa	iya
jayaaa	jaya
josss	jos
kecewaaaa	kecewa
kerennn	keren
kerennnnnnnn	keren
kontent	konten
lagggggggg	lag
lamaaa	lama
lemoooootttt	lambat
lemoooot	lambat
lemoot	lambat
lemottt	lambat
lemotttt	lambat
lemottttnya	lambat
lemottttttttttt	lambat
lemotttttttttttt	lambat
mantaaaaap	mantap
mantaaap	mantap
mantabbb	mantap
mantabbbbbbb	mantap
mantappp	mantap
mantapppp	mantap
mayindihome	myindihome
menarwarkan	menawarkan
mna	mana
moga	semoga
murahhh	murah
org	orang
paraaaaah	parah
parahhh	parah
penguna	pengguna
sangaaat	sangat
semuanyaaa	semuanya
setting	pengaturan
sukaaa	suka
terbaikkk	terbaik
terossss	terus
terpecaya	terpercaya
terusss	terus
tlolootollotlllloll	tolol
tolollll	tolol
trrooooss	terus
tuju	tujuh
wajib	wah
yaaa	iya
aangat	sangat
wow	bagus
anakx	anak
atifkan	aktifkan
bangeet	banget
bener	benar
big	besar
bkn	bukan
byr	bayar
dah	sudah
dh	sudah
gtu	begitu
kebutujan	kebutuhan
kna	kena
knp	kenapa
kontent	konten
lngsung	langsung
menarwarkan	menawarkan
moga	semoga
mwantab	mantap
okeeeeee	mantap
okkk	mantap
pdhl	padahal
penanganannnya	penanganannya
penyelesainnya	penyelesaiannya
recommmended	direkomendasikan
sending	mengirim
skli	sekali
sma	sama
stars	bintang
tlat	telat
unuk	untuk
